NO ./textures/north.xpm
SO ./textures/south.xpm
WE ./textures/west.xpm
EA ./textures/east.xpm
F 0,150,200
C 200,150,0

111111111
100000001
101110101
10N010101
101010101
100000001
111111111
