NO ./textures/north.png
SO ./textures/south.png
WE ./textures/west.png
EA ./textures/east.png
F 220,100,0
C 100,100,255

111111111111
100000000001
100011111001
10N010000001
100011011101
100000000001
111111111111
