NO ./textures/north.png
SO ./textures/south.png
WE ./textures/west.png
EA ./textures/east.png

C 100,100,255
F 220,100,0

11111111111111111111111111111111111111111111111111
10001000000000001000001000000000100000100100001001
10110000111111000000100110010010010010010100100001
10000001000000010011000001001001010001000000001011
10101110000010000000101000100100010001100001110001
10010000110010101100010010010010000010010010001001
11010000001010000011000011001010100100001100100101
10000011100100001000101000100100101000010001110001
10001100010010111110010010101001000010010100101001
10010001001010001001001010001010000010100010000101
10100111101001100100100000010001011100110010101001
10101001001000010000010100100101000010001001001001
11001000001011001010100010000101001010001000101001
10010100001100101010001001110001010000000110100001
10100010110000000001100100000100000111110000100001
10101010001001010110011000100010001000001110001101
10001001001010001000000010101001110011000001000011
10000101000010100010101010100110000100100100110001
10110100011100010101010010010000100110100110001001
10000010100010001000010001100100100000000000100001
10101010101001010010000010001000111001000010010101
10100010000101001001101100000100000100111001100001
10010011001001000100010010001000110010000010001001
11001100001010010000000000000101000010010100101011
10010001101011101011100000010101000111100101001001
10100010001000000100001110000100110010001001010101
10010011000011010101010001001110001000110010010001
10100100110100100101000101000100101101000010001001
10000100001000100100011001000100100001001101010011
100E0101000000100010100101010000011110010001000001
10011001110010100100100101010100100000100101110001
11100100001100101001001001011001001011001000000111
10000100100000001010001001000010100100001010010001
10010010001001110001000100100000010100001000001101
10100001010010000101011010100100010100001001100001
10111000100000110101000010010011010100010010001001
10000110000111000001001001001000100010010010010011
10010001101000001100010001100010010100010000010001
10011100010010100011100000010100010100010111100111
10100011000010111000001001010100000100111000010001
10001000000100000100010110010011000010010001000101
10010010101001110010100001101000101000010110001001
10000000100100001001000100000100010000100001000001
11101000000110000100101000010011001000010101011111
10010100011001011010000101001000001111010100100001
10100000100001000001110001010110000000011000000101
10100111011000100010001010000000010010000010110101
10001000000010010000001000111001000010111001001001
10000001000000000100000010000010000010000000000001
11111111111111111111111111111111111111111111111111
