NO ./textures/north.png
SO ./textures/south.png
WE ./textures/west.png
EA ./textures/east.png
F 0,150,150
C 200,150,250

111111111
100000001
101110101
10E010101
101010101
100000001
111111111
